{
  "levels": [
    {
      "id": 1,
      "name": "1-1",
      "map": [
        [8, 1, 1, 1, 8],
        [8, 1, 3, 1, 1],
        [1, 1, 2, 0, 1],
        [1, 3, 2, 0, 1],
        [1, 1, 1, 1, 1]
      ],
      "player": { "row": 2, "col": 3 }
    },
    {
      "id": 2,
      "name": "1-2",
      "map": [
        [8, 8, 1, 1, 1, 8, 8, 8],
        [8, 8, 1, 3, 1, 8, 8, 8],
        [8, 8, 1, 0, 1, 1, 1, 1],
        [1, 1, 1, 2, 2, 0, 3, 1],
        [1, 3, 0, 2, 0, 1, 1, 1],
        [1, 1, 1, 1, 2, 1, 8, 8],
        [8, 8, 8, 1, 3, 1, 8, 8],
        [8, 8, 8, 1, 1, 1, 8, 8]
      ],
      "player": { "row": 4, "col": 4 }
    },
    {
      "id": 3,
      "name": "1-3",
      "map": [
        [1, 1, 1, 1],
        [1, 0, 0, 1],
        [1, 0, 0, 1],
        [1, 2, 0, 1],
        [1, 0, 0, 1],
        [1, 0, 1, 1],
        [1, 3, 1, 8],
        [1, 1, 1, 8]
      ],
      "player": { "row": 4, "col": 1 }
    },
    {
      "id": 4,
      "name": "1-4",
      "map": [
        [1, 1, 1, 1, 1],
        [1, 3, 2, 0, 1],
        [1, 3, 2, 0, 1],
        [1, 3, 2, 0, 1],
        [1, 3, 2, 0, 1],
        [1, 0, 0, 0, 1],
        [1, 1, 1, 1, 1]
      ],
      "player": { "row": 5, "col": 3 }
    },
    {
      "id": 5,
      "name": "1-5",
      "map": [
        [1, 1, 1, 1, 1],
        [1, 3, 1, 3, 1],
        [1, 2, 2, 0, 1],
        [1, 0, 0, 0, 1],
        [1, 1, 1, 1, 1]
      ],
      "player": { "row": 3, "col": 2 }
    },
    {
      "id": 6,
      "name": "1-6",
      "map": [
        [8, 1, 1, 1, 8, 8],
        [1, 1, 3, 1, 1, 1],
        [1, 3, 2, 2, 0, 1],
        [1, 1, 0, 0, 0, 1],
        [8, 1, 1, 1, 1, 1]
      ],
      "player": { "row": 3, "col": 4 }
    },
    {
      "id": 7,
      "name": "1-7",
      "map": [
        [1, 1, 1, 1, 8, 8],
        [1, 0, 3, 1, 8, 8],
        [1, 0, 0, 1, 1, 1],
        [1, 3, 0, 0, 0, 1],
        [1, 0, 2, 2, 0, 1],
        [1, 0, 0, 1, 1, 1],
        [1, 1, 1, 1, 8, 8]
      ],
      "player": { "row": 5, "col": 2 }
    },
    {
      "id": 8,
      "name": "1-7",
      "map": [
        [1, 1, 1, 1, 1, 8],
        [1, 0, 3, 0, 1, 1],
        [1, 0, 0, 0, 0, 1],
        [1, 0, 3, 2, 0, 1],
        [1, 1, 1, 2, 0, 1],
        [8, 8, 1, 0, 0, 1],
        [8, 8, 1, 1, 1, 1]
      ],
      "player": { "row": 5, "col": 4 }
    },
    {
      "id": 9,
      "name": "1-9",
      "map": [
        [1, 1, 1, 1, 1, 8],
        [1, 0, 0, 0, 1, 1],
        [1, 0, 0, 2, 0, 1],
        [1, 1, 2, 0, 3, 1],
        [8, 1, 0, 0, 3, 1],
        [8, 1, 1, 1, 1, 1]
      ],
      "player": { "row": 2, "col": 4 }
    },
    {
      "id": 10,
      "name": "1-10",
      "map": [
        [1, 1, 1, 8, 8, 8, 8],
        [1, 3, 1, 1, 1, 1, 8],
        [1, 0, 0, 2, 0, 1, 1],
        [1, 0, 0, 2, 0, 0, 1],
        [1, 1, 1, 3, 1, 1, 1],
        [8, 8, 1, 1, 1, 8, 8]
      ],
      "player": { "row": 3, "col": 5 }
    },

    {
      "id": 11,
      "name": "2-1",
      "map": [
        [1, 1, 1, 1, 1, 1, 1],
        [1, 0, 0, 0, 0, 0, 1],
        [1, 0, 4, 4, 4, 0, 1],
        [1, 0, 4, 2, 4, 0, 1],
        [1, 0, 4, 4, 4, 0, 1],
        [1, 0, 0, 0, 3, 0, 1],
        [1, 1, 1, 1, 1, 1, 1]
      ],
      "player": { "row": 1, "col": 1 }
    },
    {
      "id": 12,
      "name": "2-2",
      "map": [
        [1, 1, 1, 1, 1, 1, 1, 1],
        [1, 0, 0, 0, 1, 0, 0, 1],
        [1, 0, 4, 4, 4, 0, 0, 1],
        [1, 0, 4, 2, 0, 0, 0, 1],
        [1, 0, 0, 1, 4, 4, 0, 1],
        [1, 0, 0, 3, 4, 0, 0, 1],
        [1, 1, 1, 1, 1, 1, 1, 1]
      ],
      "player": { "row": 2, "col": 1 }
    },
    {
      "id": 13,
      "name": "2-3",
      "map": [
        [1, 1, 1, 1, 1, 1, 1, 1, 1],
        [1, 1, 4, 4, 4, 4, 4, 4, 1],
        [1, 4, 4, 4, 1, 4, 4, 4, 1],
        [1, 4, 4, 4, 4, 4, 4, 4, 1],
        [1, 4, 4, 4, 4, 2, 3, 4, 1],
        [1, 4, 4, 1, 4, 4, 4, 4, 1],
        [1, 4, 4, 4, 4, 4, 4, 4, 1],
        [1, 1, 1, 1, 1, 1, 1, 1, 1]
      ],
      "player": { "row": 2, "col": 1 }
    },
    {
      "id": 14,
      "name": "1-3",
      "map": [
        [1, 1, 1, 1, 1,  1, 1, 1, 1],
        [1, 0, 0, 0, 0,  0, 0, 0, 1],
        [1, 0, 4, 4, 4,  4, 4, 0, 1],
        [1, 0, 4, 2, 4,  0, 4, 0, 1],
        [1, 0, 4, 4, 4,  4, 4, 1, 1],
        [1, 0, 4, 4, 4,  0, 4, 3, 1],
        [1, 0, 4, 4, 4,  4, 4, 1, 1],
        [1, 0, 0, 0, 0,  0, 0, 0, 1],
        [1, 1, 1, 1, 1,  1, 1, 1, 1]
      ],
      "player": { "row": 1, "col": 1 }
    },
    {
      "id": 15,
      "name": "1-4",
      "map": [
        [1, 1, 1, 1, 1,  1, 1, 1, 1, 1,  1],
        [1, 0, 0, 0, 0,  0, 0, 0, 0, 0,  1],
        [1, 0, 4, 4, 4,  4, 4, 4, 4, 0,  1],
        [1, 0, 4, 4, 4,  4, 1, 2, 4, 0,  1],
        [1, 0, 4, 1, 4,  4, 4, 4, 4, 0,  1],

        [1, 0, 4, 4, 4,  4, 3, 1, 4, 0,  1],
        [1, 0, 4, 4, 1,  4, 4, 4, 4, 0,  1],
        [1, 0, 4, 4, 4,  4, 4, 4, 4, 0,  1],
        [1, 0, 0, 0, 0,  0, 0, 0, 0, 0,  1],
        [1, 1, 1, 1, 1,  1, 1, 1, 1, 1,  1]
      ],
      "player": { "row": 1, "col": 1 }
    },
    {
      "id": 16,
      "name": "2-3",
      "map": [
        [1, 1, 1, 1, 1,   1, 1, 1, 1, 1,  1, 1],
        [1, 4, 4, 4, 4,   4, 4, 4, 4, 4,  4, 1],
        [1, 4, 4, 4, 1,   4, 4, 4, 4, 4,  4, 1],
        [1, 4, 4, 4, 4,   4, 4, 4, 4, 1,  4, 1], 
        [1, 4, 4, 4, 4,   1, 4, 4, 4, 4,  4, 1],

        [1, 4, 4, 1, 4,   4, 2, 4, 0, 4,  4, 1],
        [1, 4, 4, 4, 4,   4, 1, 4, 3, 4,  4, 1],
        [1, 4, 1, 4, 4,   4, 4, 4, 4, 4,  4, 1], 
        [1, 4, 4, 4, 4,   4, 4, 4, 4, 4,  4, 1],
        [1, 1, 1, 1, 1,   1, 1, 1, 1, 1,  1, 1]
      ],
      "player": { "row": 5, "col": 2 }
    },
    {
      "id": 17,
      "name": "3-2",
      "map": [
        [1, 1, 1, 1, 1,   1, 1, 1, 1, 1,  1],
        [1, 0, 0, 0, 0,   0, 0, 0, 0, 0,  1],
        [1, 0, 4, 4, 4,   1, 4, 1, 4, 0,  1],
        [1, 0, 4, 3, 4,   4, 4, 4, 1, 0,  1], 
        [1, 0, 4, 4, 4,   2, 4, 4, 4, 0,  1],

        [1, 0, 4, 4, 4,   4, 4, 4, 4, 0,  1],
        [1, 0, 4, 4, 1,   4, 4, 4, 1, 0,  1],
        [1, 0, 4, 4, 4,   1, 4, 1, 4, 0,  1], 
        [1, 0, 0, 0, 0,   0, 0, 0, 0, 0,  1],
        [1, 1, 1, 1, 1,   1, 1, 1, 1, 1,  1]
      ],
      "player": { "row": 1, "col": 1 }
    },
    {
      "id": 18,
      "name": "4-5",
      "map": [
        [1, 1, 1, 1, 1,  1, 1, 1, 1, 1,  1, 1, 1, 1, 1],
        [1, 4, 4, 4, 4,  4, 4, 4, 4, 4,  4, 4, 4, 4, 1],
        [1, 4, 4, 1, 1,  4, 4, 4, 4, 4,  4, 4, 4, 4, 1],
        [1, 4, 4, 4, 4,  4, 4, 1, 4, 1,  4, 4, 4, 4, 1], 
        [1, 4, 4, 4, 4,  1, 4, 4, 4, 4,  4, 4, 4, 4, 1],

        [1, 4, 4, 4, 4,  1, 3, 2, 4, 4,  4, 4, 4, 4, 1],
        [1, 4, 1, 4, 4,  4, 4, 4, 4, 4,  4, 4, 1, 4, 1],
        [1, 4, 4, 4, 4,  4, 4, 4, 1, 4,  4, 4, 4, 4, 1], 
        [1, 4, 4, 1, 1,  4, 4, 4, 4, 4,  4, 1, 4, 4, 1],
        [1, 4, 4, 4, 4,  4, 4, 4, 4, 1,  4, 4, 4, 4, 1],

        [1, 4, 4, 4, 4,  4, 4, 4, 4, 4,  4, 4, 4, 4, 1],
        [1, 1, 1, 1, 1,  1, 1, 1, 1, 1,  1, 1, 1, 1, 1]
      ],
      "player": { "row": 4, "col": 9 }
    },
    {
      "id": 19,
      "name": "5-1",
      "map": [
        [1, 1, 1, 1,  1, 1, 1, 1,  1, 1, 1, 1, 1],
        [1, 4, 4, 4,  4, 4, 4, 4,  4, 4, 4, 4, 1],
        [1, 4, 4, 4,  1, 1, 1, 4,  4, 4, 4, 4, 1],
        [1, 4, 4, 4,  4, 4, 4, 4,  4, 1, 4, 4, 1],

        [1, 4, 1, 4,  4, 4, 4, 4,  4, 4, 4, 4, 1],
        [1, 4, 4, 4,  4, 4, 4, 4,  6, 6, 3, 4, 1],
        [1, 4, 1, 4,  4, 4, 6, 4,  4, 4, 4, 4, 1],
        [1, 4, 1, 4,  4, 4, 4, 4,  4, 4, 4, 4, 1],

        [1, 4, 4, 4,  4, 4, 1, 1,  1, 4, 4, 4, 1],
        [1, 4, 4, 1,  1, 4, 4, 4,  4, 4, 4, 4, 1],
        [1, 4, 4, 4,  4, 4, 4, 4,  4, 4, 4, 4, 1],
        [1, 1, 1, 1,  1, 1, 1, 1,  1, 1, 1, 1, 1]
      ],
      "player": { "row": 7, "col": 8 }
    },
    {
      "id": 20,
      "name": "5-4",
      "map": [
        [1, 1, 1, 1, 1,  1, 1, 1, 1, 1,  1, 1, 1, 1, 1,  1, 1, 1, 1],
        [1, 0, 0, 0, 0,  0, 0, 0, 0, 0,  0, 0, 0, 0, 0,  0, 0, 0, 1],
        [1, 0, 4, 4, 4,  4, 4, 1, 4, 4,  4, 4, 4, 4, 4,  4, 4, 0, 1],
        [1, 0, 4, 4, 4,  4, 4, 4, 4, 4,  4, 4, 4, 4, 1,  4, 4, 0, 1], 
        [1, 0, 4, 4, 4,  4, 4, 4, 4, 4,  4, 4, 4, 4, 4,  4, 1, 0, 1],

        [1, 0, 4, 4, 4,  1, 3, 4, 3, 4,  3, 4, 3, 1, 4,  4, 4, 0, 1],
        [1, 0, 4, 4, 4,  4, 4, 4, 4, 4,  4, 4, 4, 4, 4,  4, 4, 0, 1],
        [1, 0, 1, 4, 4,  2, 4, 2, 4, 2,  4, 2, 4, 4, 4,  4, 4, 0, 1], 
        [1, 0, 4, 4, 4,  4, 4, 4, 4, 1,  4, 4, 4, 4, 4,  4, 4, 0, 1],
        [1, 0, 4, 1, 4,  4, 4, 4, 4, 4,  4, 4, 4, 4, 4,  1, 4, 0, 1],

        [1, 0, 0, 0, 0,  0, 0, 0, 0, 0,  0, 0, 0, 0, 0,  0, 0, 0, 1],
        [1, 1, 1, 1, 1,  1, 1, 1, 1, 1,  1, 1, 1, 1, 1,  1, 1, 1, 1]
      ],
      "player": { "row": 1, "col": 1 }
    }
  ]
}